"a" = (/turf/Floor/grass,/area)
"b" = (/mob/ai/blue,/turf/Floor/grass,/area)
"c" = (/mob/ai/red,/turf/Floor/grass,/area)
"d" = (/turf,/area)

(1,1,1) = {"
aaaaaaaaaaaaaaaaaaaaaaaaaaaaaaaaaaaaaaaaaaaaaaaaaa
aaaaaaaaaaaaaaaaaaaaaaaaaaaaaaaaaaaaaaaaaaaaaaaaaa
aaaaaaaaaaaaaaaaaaaaaaaaaaaaaaaaaaaaaaaaaaaaaaaaaa
aaaaaaaaaaaaaaaaaaaaaaaaaaaaaaaaaaaaaaaaaaaaaaaaaa
aaaaaaaaaaaaaaaaaaaaaaaaaaaaaaaaaaaaaaaaaaaaaaaaaa
aaaaaaaaaaaaaaaaaaaaaaaaaaaaaaaaaaaaaaaaaaaaaaaaaa
aaaaaaaaaaaaaaaaaaaaaaaaaaaaaaaaaaaaaaaaaaaaaaaaaa
aaaaaaaaaaaaaaaaaaaaaaaaaaaaaaaaaaaaaaaaaaaaaaaaaa
aaaaaaaaaaaaaaaaaaaaaaaaaaaaaaaaaaaaaaaaaaaaaaaaaa
aaaaaaaaaaaaaaaaaaaaaaaaaaaaaaaaaaaaaaaaaaaaaaaaaa
aaaaaaaaaaaaaaaaaaaaaaaaaaaaaaaaaaaaaaaaaaaaaaaaaa
aaaaaaaaaaaaaaaaaaaaaaaaaaaaaaaaaaaaaaaaaaaaaaaaaa
aaaaaaaaaaaaaaaaaaaaaaaaaaaaaaaaaaaaaaaaaaaaaaaaaa
aaaaaaaaaaaaaaaaaaaaaaaaaaaaaaaaaaaaaaaaaaaaaaaaaa
aaaaaaaaaaaaaaaaaaaaaaaaaaaaaaaaaaaaaaaaaaaaaaaaaa
aaaaaaaaaaaaaaaaaaaaaaaaaaaaaaaaaaaaaaaaaaaaaaaaaa
aaaaaaaaaaaaaaaaaaaaaaaaaaaaaaaaaaaaaaaaaaaaaaaaaa
aaaaaaaaaaaaaaaaaaaaaaaaaaaaaaaaaaaaaaaaaaaaaaaaaa
aaaaaaaaaaaaaaaaaaaaaaaaaaaaaaaaaaaaaaaaaaaaaaaaaa
aaaaaaaaaaaaaaaaaaaaaaaaaaaaaaaaaaaaaaaaaaaaaaaaaa
aaaaaaaaaaaaaaaaaaaaaaaaaaaaaaaaaaaaaaaaaaaaaaaaaa
aaaaaaaaaaaaaaaaaaaaaaaaaaaaaaaaaaaaaaaaaaaaaaaaaa
aaaaaaaaaaaaaaaaaaaaaaaaaaaaaaaaaaaaaaaaaaaaaaaaaa
aaaaaaaaaaaaaaaaaaaaaaaaaaaaaaaaaaaaaaaaaaaaaaaaaa
aaaaaaaaaaaaaaaaaaaaaaaaaaaaaaaaaaaaaaaaaaaaaaaaaa
aaaaaaaaaaaaaaaaaaaaaaaaaaaaaaaaaaaaaaaaaaaaaaaaaa
aaaaaaaaaaaaaaaaaaaaaaaaaaaaaaaaaaaaaaaaaaaaaaaaaa
aaaaaaaaaaaaaaaaaaaaaaaaaaaaaaaaaaaaaaaaaaaaaaaaaa
aaaaaaaaaaaaaaaaaaaaaaaaaaaaaaaaaaaaaaaaaaaaaaaaaa
aaaaaaaaaaaaaaaaaaaaaaaaaaaaaaaaaaaaaaaaaaaaaaaaaa
aaaaaaaaaaaaaaaaaaaaaaaaaaaaaaaaaaaaaaaaaaaaaaaaaa
aaaaaaaaaaaaaaaaaaaaaaaaaaaaaaaaaaaaaaaaaaaaaaaaaa
aaaaaaaaaaaaaaaaaaaaaaaaaaaaaaaaaaaaaaaaaaaaaaaaaa
aaaaaabaaaaaaaaaaaaaaaaacaaaaaaaaaaaaaaaaaaaaaaaaa
aaaaaaaaaaaaaaaabaaaaaaaaaaaaaaaaaaaaaaaaaaaaaaaaa
aaaaaaaaaaaaaaaaaaaaaaaaaaaaaaaaaaaaaaaaaaaaaaaaaa
aaaaaaaaaaaaaaaaaaaaaaaaaaaaaaaaaaaaaaaaaaaaaaaaaa
aaaaaaaaaaaaaaaaaaaaaabaaaaaaaaaaaaaaaaaaaaaaaaaaa
aaaaaaaaaaaaaaaaaaaaaaaaaaaaaaaaaaaaaaaaaaaaaaaaaa
aaaaaaaaacaaaaaaaaaaaaaaaaaaaaaaaaaaaaaaaaaaaaaaaa
aaaaaaaaaaaaaaaaaaaaaaaaaaaaaaaaaaaaaaaaaaaaaaaaaa
aaaaaaaaaaaaaaaaaaaaaaaaaaaaaaaaaaaaaaaaaaaaaaaaaa
aaaaaaaaaaaaaaaaaaaaaaaaaaaaaaaaaaaaaaaaaaaaaaaaaa
aaaaaaaaaaaaaaaaaaaaaaaaaaaaaaaaaaaaaaaaaaaaaaaaaa
aaaaaaaaaaaaaaaaaaaaaaaaaaaaaaaaaaaaaaaaaaaaaaaaaa
aaaaaaaaaaaaaaaaaaaaaaaaaaaaaaaaaaaaaaaaaaaaaaaaaa
aaaaaaaaaaaaaaaaaaaaaaaaaaaaaaaaaaaaaaaaaaaaaaaaaa
aaaaaaaaaaaaaaaaaaaaaaaaaaaaaaaaaaaaaaaaaaaaaaaaaa
aaaaaaaaaaaaaaaaaaaaaaaaaaaaaaaaaaaaaaaaaaaaaaaaaa
aaaaaaaaaaaaaaaaaaaaaaaaaaaaaaaaaaaaaaaaaaaaaaaaaa
"}

(1,1,2) = {"
aaaaaaaaaaaaaaaaaaaaaaaaaaaaaaaaaaaaaadddddddddddd
aaaaaaaaaaaaaaaaaaaaaaaaaaaaaaaaaaaaaadddddddddddd
aaaaaaaaaaaaaaaaaaaaaaaaaaaaaaaaaaaaaadddddddddddd
aaaaaaaaaaaaaaaaaaaaaaaaaaaaaaaaaaaaaadddddddddddd
aaaaaaaaaaaaaaaaaaaaaaaaaaaaaaaaaaaaaadddddddddddd
aaaaaaaaaaaaaaaaaaaaaaaaaaaaaaaaaaaaaadddddddddddd
aaaaaaaaaaaaaaaaaaaaaaaaaaaaaaaaaaaaaadddddddddddd
aaaaaaaaaaaaaaaaaaaaaaaaaaaaaaaaaaaaaadddddddddddd
aaaaaaaaaaaaaaaaaaaaaaaaaaaaaaaaaaaaaadddddddddddd
aaaaaaaaaaaaaaaaaaaaaaaaaaaaaaaaaaaaaaaaaaaaaaaaaa
aaaaaaaaaaaaaaaaaaaaaaaaaaaaaaaaaaaaaaaaaaaaaaaaaa
aaaaaaaaaaaaaaaaaaaaaaaaaaaaaaaaaaaaaaaaaaaaaaaaaa
aaaaaaaaaaaaaaaaaaaaaaaaaaaaaaaaaaaaaaaaaaaaaaaaaa
aaaaaaaaaaaaaaaaaaaaaaaaaaaaaaaaaaaaaadddddddddddd
aaaaaaaaaaaaaaaaaaaaaaaaaaaaaaaaaaaaaadddddddddddd
aaaaaaaaaaaaaaaaaaaaaaaaaaaaaaaaaaaaaadddddddddddd
aaaaaaaaaaaaaaaaaaaaaaaaaaaaaaaaaaaaaadddddddddddd
aaaaaaaaaaaaaaaaaaaaaaaaaaaaaaaaaaaaaadddddddddddd
aaaaaaaaaaaaaaaaaaaaaaaaaaaaaaaaaaaaaadddddddddddd
aaaaaaaaaaaaaaaaaaaaaaaaaaaaaaaaaaaaaadddddddddddd
aaaaaaaaaaaaaaaaaaaaaaaaaaaaaaaaaaaaaadddddddddddd
aaaaaaaaaaaaaaaaaaaaaaaaaaaaaaaaaaaaaadddddddddddd
aaaaaaaaaaaaaaaaaaaaaaaaaaaaaaaaaaaaaadddddddddddd
aaaaaaaaaaaaaaaaaaaaaaaaaaaaaaaaaaaaaadddddddddddd
aaaaaaaaaaaaaaaaaaaaaaaaaaaaaaaaaaaaaadddddddddddd
aaaaaaaaaaaaaaaaaaaaaaaaaaaaaaaaaaaaaadddddddddddd
aaaaaaaaaaaaaaaaaaaaaaaaaaaaaaaaaaaaaadddddddddddd
aaaaaaaaaaaaaaaaaaaaaaaaaaaaaaaaaaaaaadddddddddddd
aaaaaaaaaaaaaaaaaaaaaaaaaaaaaaaaaaaaaadddddddddddd
aaaaaaaaaaaaaaaaaaaaaaaaaaaaaaaaaaaaaaaaaaaaaadddd
ddddddddddddddddddddddddddaaaaaaaaaaaaaaaaaaaadddd
ddddddddddddddddddddddddddaaaaaaaaaaaaaaaaaaaadddd
ddddddddddddddddddddddddddaaaaaaaaaaaaaaaaaaaadddd
ddddddddddddddddddddddddddaaaaaaaaaaaaaaaaaaaadddd
ddddddddddddddddddddddddddaaaaaaaaaaaaaaaaaaaadddd
ddddddddddddddddddddddddddaaaaaaaaaaaaaaaaaaaadddd
ddddddddddddddddddddddddddaaaaaaaaaaaaaaaaaaaadddd
aaaaaaaaaaaaaaadddddddddddaaaaaaaaaaaaaaaaaaaadddd
aaaaaaaaaaaaaaadddddddddddaaaaaaaaaaaaaaaaaaaadddd
aaaaaaaaaaaaaaadddddddddddaaaaaaaaaaaaaaaaaaaadddd
aaaaaaaaaaaaaaadddddddddddaaaaaaaaaaaaaaaaaaaadddd
aaaaaaaaaaaaaaadddddddddddaaaaaaaaaaaaaaaaaaaadddd
aaaaaaaaaaaaaaadddddddddddaaaaaaaaaaaaaaaaaaaadddd
aaaaaaaaaaaaaaadddddddddddaaaaaaaaaaaaaaaaaaaadddd
aaaaaaaaaaaaaaadddddddddddaaaaaaaaaaaaaaaaaaaadddd
aaaaaaaaaaaaaaadddddddddddaaaaaaaaaaaaaaaaaaaadddd
aaaaaaaaaaaaaaadddddddddddaaaaaaaaaaaaaaaaaaaadddd
aaaaaaaaaaaaaaadddddddddddaaaaaaaaaaaaaaaaaaaadddd
aaaaaaaaaaaaaaadddddddddddaaaaaaaaaaaaaaaaaaaadddd
aaaaaaaaaaaaaaadddddddddddaaaaaaaaaaaaaaaaaaaadddd
"}
